j##################################################################################################j
j..................................................................................................j
j..................................................................................................j
j.............................................l##v...................l##v..........................j
j..................................................................................................j
j.................l##v.............................................................................j
j..................................................................................................j
j.......................................................l##v....................l##v...............j
j.................................l##v.............................................................j
j..................................................................................................j
j..................................................................................................j
j........u......p......u.............u..........h...........r......................................j
jl########################################################################v#l#####################vj
j..................................................................................................j
j.................................l###v..................l##v......................................j
j..l###v............l##v..........................l##v............h...............l##v.............j
j..........................................h....................l##v...............................j
j........l##v.............l##v............l###v.........................................l##v....h..j
j..........r...................................................................................l##vj
nnnnnnnnnnnnnnnnnnnnnnnnnnnnnnnnnnnnnnnnnnnnnnnnnnnnnnnnnnnnnnnnnnnnnnnnnnnnnnnnnnnnnnnnnnnnnnnnnnnn
