Q##################################################################################################Q
Q..................................................................................................Q
QG.....................................................................7..........................FQ
Q.............................................{@@y...................{@@y..........................Q
Q..................8...............................................................................Q
Q.................{@@y.............................................................................Q
Q.................................................................................5................Q
QG..................................5...................{@@y....................{@@y...............Q
Q.................................{@@y............................................................FQ
Q..................................................................................................Q
QG.................................................................................................Q
Q..............p..................9....9...............7.............9......................8.....*Q
Qd########################################################################v...d###################vQ
Q............d#####v..................................7............................................Q
Q.....5...........................{@@@y..................{@@y.......................5.............FQ
Q..{@@@y............{@@y..........................{@@y............h...............{@@y.............Q
QG.........................................h....................{@@y.......................9.......Q
Q........{@@y.............{@@y............{@@@y.........................................{@@y....R..Q
Qt.........r...........9.....................9....9................9...........................{@@yQ
nnnnnnnnnnnnnnnnnnnnnnnnnnnnnnnnnnnnnnnnnnnnnnnnnnnnnnnnnnnnnnnnnnnnnnnnnnnnnnnnnnnnnnnnnnnnnnnnnnnn
