Q##################################################################################################Q
Q.................................................................................................FQ
Q...............................................8..................................................Q
Q.............................................d##v...................d##v..........................Q
Q...................2.............................................................................RQ
QG................d##v...........................................................................FIQ
Q.........................................................2........................................Q
Q...................................7...................d##v....................d##v...............Q
Q.................................d##v............................................................RQ
QG...............................................................................................FIQ
Q..................................................................................................Q
Q*..........................p......................9999...................8......................R.Q
Qd###v...d########################################################################################vQ
Q..........................d##v...................................................................RQ
Q.................................d###v..................d##v......................r.............FIQ
Q..d###v............d##v..........................d##v............h...............d##v.............Q
Q...........................8..............h....................d##v......................t........Q
Q........d##v.............d##v............d###v.........................................d##v......RQ
QG....7....h................................................9..9..9..9..9..9..9..9..9..........d##vQ
nnnnnnnnnnnnnnnnnnnnnnnnnnnnnnnnnnnnnnnnnnnnnnnnnnnnnnnnnnnnnnnnnnnnnnnnnnnnnnnnnnnnnnnnnnnnnnnnnnnn