=..........................................................=
=..........................................................=
=..........................................................=
=..........................................................=
=..........................................................=
=..........................................................=
=..p.h.....................................................=
=.=====....................................................=
=................==================........................=
=..........................................................=
=..........................................................=
=........h.................................................=
=.......======.............................................=
=..........................................................=
=....................h.....................................=
=..............==========\.................................=
=..................................................########=
=..................................................=========
=..........................................................=
=..........................................................=
=..........................................................=
=..........................................................=
=..........................................................=
=..........................................................=
=..........................................................=
=..........................................................=
=..======..................................................=
=.......=......=========================...................=
=..........................................................=
=..........................................................=
=..........................................................=
=..........................................................=
...........................................................=
............................................................
............................................................
............................................................
............................................................
............................................................
............................................................
............................................................
............................................................
............................................................
............................................................
............................................................
============================================================
............................................................
............................................................
............................................................
............................................................
............................................................
............................................................
............................................................
............................................................
............................................................
............................................................
............................................................
............................................................
............................................................
............................................................
............................................................
